	Individual ID	Mutation Type	Total	Shared Count	Shared	FFPE Only Count	FFPE Only
0	H134753	SNVs	86066	2990	0.034740780331373594	83076	0.9652592196686264
1	H135022	SNVs	1533442	3911	0.002550471423112188	1529531	0.9974495285768878
2	H135387	SNVs	44287	3592	0.08110732269063156	40695	0.9188926773093684
3	H156407	SNVs	53963	5945	0.11016807812760596	48018	0.889831921872394
4	H158273	SNVs	66052	3094	0.046841882153454854	62958	0.9531581178465451
5	H158878	SNVs	269219	1748	0.006492855259101327	267471	0.9935071447408986
6	H158880	SNVs	20613	1537	0.07456459515839518	19076	0.9254354048416048
7	H158918	SNVs	225368	321	0.0014243370842355614	225047	0.9985756629157644
8	H159369	SNVs	37696	3419	0.09069927843803056	34277	0.9093007215619694
9	H135462	SNVs	361240	30630	0.08479127449894806	330610	0.9152087255010519
10	H201536	SNVs	1501102	8939	0.005954958423877925	1492163	0.9940450415761221
11	H201537	SNVs	2409685	8362	0.0034701631126060044	2401323	0.996529836887394
12	H201538	SNVs	1124115	5560	0.004946113164578357	1118555	0.9950538868354216
13	H201539	SNVs	2015572	9461	0.004693952882854098	2006111	0.9953060471171459
14	H201540	SNVs	1620701	9679	0.005972107131420293	1611022	0.9940278928685797
15	H201542	SNVs	1226608	10300	0.008397140732817656	1216308	0.9916028592671824
16	H203495	SNVs	699032	4998	0.007149887272685657	694034	0.9928501127273144
17	H203498	SNVs	443786	2461	0.005545465607297211	441325	0.9944545343927028
18	H203499	SNVs	66380	43243	0.6514462187405845	23137	0.3485537812594155
19	H203500	SNVs	189372	37323	0.1970882707052785	152049	0.8029117292947215
20	H203501	SNVs	122799	7754	0.06314383667619443	115045	0.9368561633238056
21	H203502	SNVs	24374	9196	0.37728727332403383	15178	0.6227127266759662
22	H203503	SNVs	185163	13598	0.07343799787214508	171565	0.9265620021278549
23	H203504	SNVs	110671	70984	0.6413965718209829	39687	0.3586034281790171
24	H203505	SNVs	78046	1768	0.022653307024062732	76278	0.9773466929759372
25	H203506	SNVs	54151	2395	0.044228176764972024	51756	0.955771823235028
26	H203507	SNVs	95943	9819	0.10234201557174573	86124	0.8976579844282543
27	H203508	SNVs	175767	106846	0.6078843013762538	68921	0.39211569862374623
28	H203511	SNVs	72435	43493	0.6004417753848278	28942	0.3995582246151722
29	H203512	SNVs	194126	6508	0.03352461803158773	187618	0.9664753819684123
30	H203513	SNVs	254674	11873	0.046620385276863754	242801	0.9533796147231363
31	H203514	SNVs	230791	6537	0.028324328071718568	224254	0.9716756719282814
32	H203515	SNVs	47219	10071	0.21328278870793538	37148	0.7867172112920646
33	H203516	SNVs	224479	15250	0.06793508524182663	209229	0.9320649147581733
34	H203517	SNVs	75983	19594	0.2578734716976166	56389	0.7421265283023835
35	H203518	SNVs	74662	3318	0.044440277517344834	71344	0.9555597224826552
36	H203519	SNVs	195396	5824	0.029806137280189972	189572	0.97019386271981
37	H203520	SNVs	192413	11328	0.058873360947545125	181085	0.9411266390524549
38	H203522	SNVs	1489962	7282	0.004887372966558879	1482680	0.9951126270334412
39	H203523	SNVs	35911	9218	0.2566901506502186	26693	0.7433098493497814
40	H203524	SNVs	203988	29443	0.14433692177971252	174545	0.8556630782202874
41	H203525	SNVs	171607	5927	0.03453821813795475	165680	0.9654617818620452
42	H203526	SNVs	1816707	1432945	0.7887595523108569	383762	0.21124044768914305
43	H203527	SNVs	49602	7987	0.16102173299463732	41615	0.8389782670053627
44	H203530	SNVs	61835	5400	0.08732918250181936	56435	0.9126708174981807
45	H203531	SNVs	73899	3902	0.052801797047321346	69997	0.9471982029526786
46	H203532	SNVs	52882	6155	0.11639121061987065	46727	0.8836087893801293
47	H203533	SNVs	18163	4191	0.23074381985354842	13972	0.7692561801464516
48	H203534	SNVs	636644	2060	0.003235717292552824	634584	0.9967642827074472
49	H203535	SNVs	30940	10370	0.33516483516483514	20570	0.6648351648351648
50	H203537	SNVs	69200	9595	0.13865606936416186	59605	0.8613439306358381
51	H203539	SNVs	93931	71333	0.759419148098072	22598	0.24058085190192802
52	H203540	SNVs	148678	5583	0.037550949030791377	143095	0.9624490509692086
53	H203541	SNVs	16423	2342	0.14260488339523839	14081	0.8573951166047616
54	H203542	SNVs	231111	10308	0.04460194452016564	220803	0.9553980554798344
55	H203544	SNVs	130826	9305	0.0711250057328054	121521	0.9288749942671946
0	H134753	Indels	27737	691	0.024912571655189817	27046	0.9750874283448102
1	H135022	Indels	163295	765	0.0046847729569184605	162530	0.9953152270430815
2	H135387	Indels	206529	525	0.0025420158912307714	206004	0.9974579841087692
3	H156407	Indels	202729	1273	0.0062793186963877885	201456	0.9937206813036122
4	H158273	Indels	133214	627	0.004706712507694387	132587	0.9952932874923056
5	H158878	Indels	38346	1018	0.026547749439315704	37328	0.9734522505606843
6	H158880	Indels	187268	2557	0.013654228164982806	184711	0.9863457718350171
7	H158918	Indels	248283	106	0.0004269321701445528	248177	0.9995730678298554
8	H159369	Indels	209246	639	0.0030538218173824113	208607	0.9969461781826175
9	H135462	Indels	210532	12018	0.057083958733114205	198514	0.9429160412668858
10	H201536	Indels	38721	1409	0.03638852302368224	37312	0.9636114769763178
11	H201537	Indels	42788	1349	0.03152753108348135	41439	0.9684724689165186
12	H201538	Indels	31529	477	0.015128928922579212	31052	0.9848710710774208
13	H201539	Indels	45713	1240	0.0271257629120819	44473	0.9728742370879181
14	H201540	Indels	59701	1405	0.023533944155039278	58296	0.9764660558449607
15	H201542	Indels	24548	1363	0.0555238715985009	23185	0.9444761284014991
16	H203495	Indels	62485	1027	0.01643594462671041	61458	0.9835640553732896
17	H203498	Indels	48404	476	0.009833898024956616	47928	0.9901661019750434
18	H203499	Indels	83992	4065	0.04839746642537385	79927	0.9516025335746262
19	H203500	Indels	67243	2015	0.029965944410570617	65228	0.9700340555894293
20	H203501	Indels	51874	1645	0.031711454678644405	50229	0.9682885453213556
21	H203502	Indels	82389	1954	0.023716758305113547	80435	0.9762832416948865
22	H203503	Indels	58725	3969	0.06758620689655172	54756	0.9324137931034483
23	H203504	Indels	85280	2764	0.0324108818011257	82516	0.9675891181988743
24	H203505	Indels	64782	307	0.0047389707017381376	64475	0.9952610292982619
25	H203506	Indels	71553	728	0.010174276410492922	70825	0.989825723589507
26	H203507	Indels	69600	2810	0.04037356321839081	66790	0.9596264367816092
27	H203508	Indels	385361	257864	0.6691491873853348	127497	0.3308508126146652
28	H203511	Indels	74885	2414	0.0322360953461975	72471	0.9677639046538025
29	H203512	Indels	47522	788	0.016581793695551534	46734	0.9834182063044484
30	H203513	Indels	67346	4252	0.06313663766222195	63094	0.936863362337778
31	H203514	Indels	80388	1148	0.014280738418669453	79240	0.9857192615813305
32	H203515	Indels	74344	1806	0.024292478209404927	72538	0.9757075217905951
33	H203516	Indels	76760	11742	0.15297029702970297	65018	0.847029702970297
34	H203517	Indels	68443	4402	0.06431629238928743	64041	0.9356837076107125
35	H203518	Indels	53168	676	0.012714414685525128	52492	0.9872855853144749
36	H203519	Indels	50728	1333	0.02627740104084529	49395	0.9737225989591547
37	H203520	Indels	65765	3716	0.05650421956967992	62049	0.9434957804303201
38	H203522	Indels	70985	2896	0.04079735155314503	68089	0.959202648446855
39	H203523	Indels	62990	1296	0.02057469439593586	61694	0.9794253056040642
40	H203524	Indels	49779	1011	0.020309769179774603	48768	0.9796902308202254
41	H203525	Indels	62427	1433	0.022954811219504382	60994	0.9770451887804956
42	H203526	Indels	201978	122341	0.6057144837556565	79637	0.39428551624434344
43	H203527	Indels	67759	1614	0.02381971398633392	66145	0.9761802860136661
44	H203530	Indels	74561	886	0.011882887836804764	73675	0.9881171121631952
45	H203531	Indels	63726	859	0.01347958447101654	62867	0.9865204155289835
46	H203532	Indels	78606	1987	0.02527796860290563	76619	0.9747220313970943
47	H203533	Indels	94630	800	0.0084539786537039	93830	0.9915460213462961
48	H203534	Indels	78391	330	0.004209666926050184	78061	0.9957903330739498
49	H203535	Indels	71038	1295	0.018229679889636533	69743	0.9817703201103635
50	H203537	Indels	86614	4133	0.047717459071281776	82481	0.9522825409287182
51	H203539	Indels	182537	53793	0.2946964177125733	128744	0.7053035822874266
52	H203540	Indels	166316	2216	0.013324033767045865	164100	0.9866759662329542
53	H203541	Indels	88122	492	0.005583168788724722	87630	0.9944168312112753
54	H203542	Indels	110056	6272	0.05698916915025078	103784	0.9430108308497492
55	H203544	Indels	119423	5537	0.04636460313339976	113886	0.9536353968666003
0	H134753	SVs	126	33	0.2619047619047619	93	0.7380952380952381
1	H135022	SVs	1981	550	0.27763755678950025	1431	0.7223624432104997
2	H135387	SVs	629	134	0.21303656597774245	495	0.7869634340222575
3	H156407	SVs	326	50	0.15337423312883436	276	0.8466257668711656
4	H158273	SVs	524	251	0.47900763358778625	273	0.5209923664122137
5	H158878	SVs	140	11	0.07857142857142857	129	0.9214285714285714
6	H158880	SVs	427	144	0.3372365339578454	283	0.6627634660421545
7	H158918	SVs	714	2	0.0028011204481792717	712	0.9971988795518207
8	H159369	SVs	840	395	0.47023809523809523	445	0.5297619047619048
9	H135462	SVs	1461	716	0.49007529089664614	745	0.5099247091033539
10	H201536	SVs	9557	266	0.027833001988071572	9291	0.9721669980119284
11	H201537	SVs	6276	135	0.021510516252390057	6141	0.9784894837476099
12	H201538	SVs	7689	125	0.016256990505917543	7564	0.9837430094940824
13	H201539	SVs	9040	467	0.05165929203539823	8573	0.9483407079646018
14	H201540	SVs	8498	342	0.04024476347375853	8156	0.9597552365262415
15	H201542	SVs	2751	212	0.07706288622319157	2539	0.9229371137768084
16	H203495	SVs	1163	14	0.012037833190025795	1149	0.9879621668099742
17	H203498	SVs	1181	54	0.04572396274343776	1127	0.9542760372565622
18	H203499	SVs	690	185	0.26811594202898553	505	0.7318840579710145
19	H203500	SVs	766	36	0.04699738903394256	730	0.9530026109660574
20	H203501	SVs	1056	25	0.023674242424242424	1031	0.9763257575757576
21	H203502	SVs	953	475	0.49842602308499473	478	0.5015739769150053
22	H203503	SVs	1051	60	0.05708848715509039	991	0.9429115128449096
23	H203504	SVs	812	90	0.11083743842364532	722	0.8891625615763546
24	H203505	SVs	661	18	0.02723146747352496	643	0.972768532526475
25	H203506	SVs	573	86	0.15008726003490402	487	0.849912739965096
26	H203507	SVs	1035	42	0.04057971014492753	993	0.9594202898550724
27	H203508	SVs	1488	187	0.1256720430107527	1301	0.8743279569892473
28	H203511	SVs	788	193	0.24492385786802032	595	0.7550761421319797
29	H203512	SVs	1011	267	0.26409495548961426	744	0.7359050445103857
30	H203513	SVs	776	30	0.03865979381443299	746	0.961340206185567
31	H203514	SVs	881	21	0.02383654937570942	860	0.9761634506242906
32	H203515	SVs	772	124	0.16062176165803108	648	0.8393782383419689
33	H203516	SVs	605	38	0.0628099173553719	567	0.9371900826446281
34	H203517	SVs	697	61	0.08751793400286945	636	0.9124820659971306
35	H203518	SVs	729	65	0.08916323731138547	664	0.9108367626886146
36	H203519	SVs	655	26	0.03969465648854962	629	0.9603053435114504
37	H203520	SVs	868	49	0.056451612903225805	819	0.9435483870967742
38	H203522	SVs	3210	7	0.0021806853582554517	3203	0.9978193146417446
39	H203523	SVs	1471	504	0.34262406526172673	967	0.6573759347382733
40	H203524	SVs	1739	645	0.3709028177113283	1094	0.6290971822886716
41	H203525	SVs	760	268	0.3526315789473684	492	0.6473684210526316
42	H203526	SVs	619	30	0.048465266558966075	589	0.9515347334410339
43	H203527	SVs	552	47	0.08514492753623189	505	0.9148550724637681
44	H203530	SVs	883	48	0.05436013590033975	835	0.9456398640996603
45	H203531	SVs	867	112	0.12918108419838523	755	0.8708189158016147
46	H203532	SVs	727	25	0.0343878954607978	702	0.9656121045392022
47	H203533	SVs	375	34	0.09066666666666667	341	0.9093333333333333
48	H203534	SVs	730	14	0.019178082191780823	716	0.9808219178082191
49	H203535	SVs	907	40	0.044101433296582136	867	0.9558985667034179
50	H203537	SVs	918	71	0.07734204793028322	847	0.9226579520697168
51	H203539	SVs	896	180	0.20089285714285715	716	0.7991071428571429
52	H203540	SVs	1145	45	0.039301310043668124	1100	0.9606986899563319
53	H203541	SVs	683	46	0.06734992679355783	637	0.9326500732064422
54	H203542	SVs	2180	166	0.07614678899082569	2014	0.9238532110091743
55	H203544	SVs	2366	541	0.22865595942519018	1825	0.7713440405748098
